........................................
........................................
########################################
########################################
########################################
##...###################################
##...###################################
##########################...###########
##########################...###########
########################################
#############.....######################
#############.....######################
########################################
##....##################################
##....################....##############
#####################.....##############
########################################
########################################
##.....#################################
#.....#######################.....######
##############.....##########.....######
#############......#####################
########################################
########################################
#############################....#######
#.....######################.....#######
#.....##################################
################....####################
.......#########....####################
.......#################################